MMMMMMMMMMM
M         M
M6        M
M     M   M
MMMMMMMMMMM

H,2,2,5,3,3
T,1,1,3,3,2
T,3,1,3,3,2
S,3,9,3,3,2
S,2,8,3,3,2
S,3,7,3,3,2
F,1,9,3,2,1
